10 10
1 1
10 10
1 1 1 X 1 1 4 7 8 X
X 1 1 X 1 1 1 5 8 8
X 1 1 X 1 1 1 4 6 7
X 1 1 X 1 X 1 1 3 6
X 1 1 1 1 X 1 1 1 1
X 1 1 1 1 X 1 1 1 1
X 1 1 X X X X 1 1 X
X 1 X X X X X 1 1 X
X 8 1 8 1 8 1 1 1 X
X X X X X X X X 1 1